sedia lapang kerja kurang miskin program makan siang gratis baik karena banyak masyarakat nilai bijak sebut anggar negara	train
tanya lihat alam prabowo subianto calon diri bagai calon presiden hingga ini paling pantas pantas presiden adalah anies baswedan	train
akhir ganti gibran rakabuming raka sosok tuju utama adalah prabowo subianto anies baswedan hanya partai pimpin negara	train
bapak anies baswedan jauh lebih	train
survei populi center laksana oktober hingga november tunjuk elektabilitas prabowo subianto gibran rakabuming raka besar ganjar pranowo mahfud anies baswedan muhaimin iskandar kata kamis november	train
tingkat elektabilitas pasang calon pilih presiden hari tunjuk prabowo subianto gibran rakabuming raka besar ganjar pranowo mahfud anies baswedan muhaimin iskandar pilih belum pilih	train
simulasi putar tunjuk head head prabowo subianto gibran rakabuming raka lawan ganjar pranowo mahfud pilih belum pilih sedang head head prabowo subianto gibran rakabuming raka versus anies baswedan muhaimin iskandar masing masing dan pilih belum pilih	train
survei prancis tunjuk prabowo subianto unggul padahal kampanye anies baswedan langsung jangan jangan survei sebut mana benar benar	train
tiga calon presiden bahas indonesia beda anies baswedan ganjar pranowo prabowo subianto	train
dasar tingkat elektabilitas pasang calon pilpres laksana hari prabowo subianto gibran rakabuming raka ganjar pranowo mahfud anies baswedan muhaimin iskandar pilih belum pilih	train
peta elektabilitas kini tunjuk pasang prabowo gibran unggul sedang anies ganjar libat saing ketat	train
percaya baca survei selalu tunjuk ganjar prabowo unggul banding anies percaya hasil survei sebut fokus adalah kerja lapang	train
utama suara prabowo anies tingkat	train
tingkat elektabilitas pasang calon pilpres laksana hari prabowo subianto gibran rakabuming raka ganjar pranowo mahfud anies baswedan muhaimin iskandar pilih putus	train
tiga calon presiden turut nilai pasang prabowo ganjar milik program hasil nyata sedang bapak anies lebih program jelas capai hasil lebih nyata	train
turut pasang akan putar adalah prabowo anies anies bagai menang ini salah partai demokrat pilih cawapres gibran partai demokrat baik pks pkb dapat gabung kabinet	train
tahun prabowo anies sedang ganjar anggap bagai main	train
sumatera elektabilitas pasang anies muhaimin ganjar mahfud prabowo gibran unggul atas anies besar	train
ganjar dukung prabowo anies	train
dukung prabowo jangan beri suara anies	train
serang serang hadap keluarga jokowi media sosial nyata cukup tingkat suara ganjar justru dukung jokowi dukung ganjar alih cara besar besar prabowo gibran bagi anies dapat akibat	train
apabila pasang prabowo ganjar mampu kalah anies cak imin justru pilih gibran ini sungguh bapak apabila bapak milik hubung kondisi baik	train
ganjar prabowo anies sedang siapa benar menang	train
hingga ini nilai hadap calon presiden ganjar kurang berani sedikit oportunis milik baik cukup cerdas prabowo berani kurang bijak mudah anies oportunis kata kurang	train
diri partai politik calon lalu pilih rakyat itu cukup prabowo bapak lalu bagaimana baik kampanye pilih prabowo demikian siapa akan pilih ganjar anies	train
dasar survei pasang anies muhaimin ganjar mahfud raih prabowo gibran capai selisih suara prabowo gibran unggul banding ganjar mahfud pilih dukung jokowi makin dukung prabowo lanjut maju bangsa	train
turut survei poltracking nasional wilayah indonesia barat tengah timur pasang anies muhaimin ganjar mahfud prabowo gibran selisih suara prabowo gibran unggul banding ganjar mahfud pilih dukung jokowi makin dukung prabowo lanjut maju bangsa	train
satu satu calon presiden prabowo paling pantas bapak anies	train
bagaimana anies sungguh sungguh turun terus laku bagai beda ganjar prabowo lebih dukung elit politik	train
simulasi putar head head pasang prabowo subianto gibran rakabuming raka suara ganjar pranowo mahfud raih undecided voters besar simulasi head head prabowo subianto gibran rakabuming raka anies baswedan muhaimin iskandar prabowo gibran capai anies muhaimin undecided voters	train
siapa pasang calon presiden wakil presiden paling perhati perempuan visi misi tiga pasang calon kata perempuan hasil anies muhaimin sebut kata perempuan banyak prabowo gibran banyak ganjar mahfud banyak sila perhati program bawah	train
perlu sebut muhammadiyah muhammadiyah dukung anies sedang dukung prabowo asal elit	train
prabowo ganjar mahfud gibran jokowi nyata anies sosok cerdas anies memang calon presiden paling pantas pimpin indonesia	train
serang hadap jokowi keluarga justru tingkat elektabilitas prabowo gibran anies muhaimin elektabilitas ganjar mahfud turun ini rupa akibat tindak terus terus henti	train
anies muhaimin unggul atas ganjar mahfud sumatera jawa barat dki jakarta banten elektabilitas masih bawah prabowo gibran	train
banyak pilih jokowi putus pilih ganjar alih prabowo gibran balik pilih prabowo besar sedikit ganjar prabowo raih menang signifikan pilpres sedang anies	train
tingkat elektabilitas pasang calon survei pilpres hari adalah bagai ikut prabowo subianto gibran rakabuming raka ganjar pranowo mahfud anies baswedan muhaimin iskandar pilih belum pilih besar	train
turut simulasi pilpres kini elektabilitas pasang calon prabowo subianto gibran rakabuming raka ganjar pranowo mahfud anies baswedan muhaimin iskandar pilih tentu pilih capai	train
dukung calon baik cari perhati bagaimana ganjar anies prabowo visi misi dapat pilih bijak jangan nilai satu pilpres rupa penting masyarakat bukan hanya	train
pada pilpres putar akan dukung siapa lawan prabowo baik ganjar maupun anies juang jangan menang pilih	train
wilayah malu pasang anies baswedan muhaimin iskandar pasang ganjar pranowo mahfud dan pasang prabowo subianto gibran rakabuming raka ganjar pranowo mahfud unggul atas prabowo subianto gibran rakabuming raka besar	train
simulasi putar antara pasang prabowo subianto gibran rakabuming raka lawan ganjar pranowo mahfud prabowo subianto gibran rakabuming raka ganjar pranowo mahfud dan pilih belum pilih besar dalam simulasi putar antara prabowo subianto gibran rakabuming raka lawan anies baswedan muhaimin iskandar prabowo subianto gibran rakabuming raka anies baswedan muhaimin iskandar dan pilih belum pilih besar	train
simulasi putar antara pasang prabowo subianto gibran rakabuming raka lawan ganjar pranowo mahfud prabowo subianto gibran rakabuming raka ganjar pranowo mahfud dan pilih belum pilih besar dalam simulasi putar antara prabowo subianto gibran rakabuming raka lawan anies baswedan muhaimin iskandar prabowo subianto gibran rakabuming raka anies baswedan muhaimin iskandar dan pilih belum pilih besar	train
anies baswedan prabowo subianto maju bagai calon presiden lalu	train
kampanye serang gibran rakabuming raka lalu media sosial nyata survei akhir justru tunjuk tingkat elektabilitas prabowo subianto anies baswedan elektabilitas ganjar pranowo turun baik anggar lebih besar laku kampanye langsung lapang capai hasil	train
wilayah dki jakarta banten pasang anies baswedan muhaimin iskandar pasang ganjar pranowo mahfud dan pasang prabowo subianto gibran rakabuming raka pasang prabowo subianto gibran rakabuming raka unggul atas anies baswedan muhaimin iskandar besar	train
dasar survei poltracking elektabilitas prabowo subianto terus tingkat kini unggul atas ganjar pranowo anies baswedan	train
turut hasil survei lembaga pilih ikut arah presiden apabila ini bukti benar prabowo subianto menang pilih presiden satu putar jika perlu putar suara dukung anies baswedan prabowo subianto	train
wilayah jawa barat pasang anies baswedan muhaimin iskandar pasang ganjar pranowo mahfud dan pasang prabowo subianto gibran rakabuming raka pasang prabowo subianto gibran rakabuming raka unggul atas anies baswedan muhaimin iskandar besar	train
simulasi putar antara pasang prabowo subianto gibran rakabuming raka lawan ganjar pranowo mahfud prabowo subianto gibran rakabuming raka ganjar pranowo mahfud dan pilih belum pilih besar dalam simulasi putar antara prabowo subianto gibran rakabuming raka lawan anies baswedan muhaimin iskandar prabowo subianto gibran rakabuming raka anies baswedan muhaimin iskandar dan pilih belum pilih besar	train
turut hari prabowo suara lanjut jatuh ganti gibran rasa kurang alam gibran ganti oleh anies anggap milik tara menteri	train
prabowo bukti langgar ham belum jalan maupun meski pernah dukung prabowo akal sehat calon wakil presiden kait langgar ham jelas malu cermin semua kandidat lebih pilih anies	train
cukup aneh apabila prabowo unggul padahal dukung alih anies itu prabowo kaesang tuju tarik jokowi padahal dukung jokowi alih ganjar tahun pihak sengaja unggul	train
tolak pilih partai banteng pilih anies sehat jika tolak partai banteng pilih prabowo sebut tampak logis	train
tengah internasional kait palestina perhati masyarakat tuju politik nasional pilpres masuk calon presiden calon wakil presiden prabowo subianto gibran rakabuming anies baswedan ganjar pranowo itu arah dukung nasional laksana dunia	train
komentar komentar sebut buzzer duga pihak prabowo sengaja cari tiap bapak anies dapat tumpang bahas kena beliau	train
turut survei elektabilitas pasang anies muhaimin capai ganjar mahfud prabowo gibran besar pasang prabowo gibran unggul atas ganjar mahfud pilih jokowi makin dukung prabowo lanjut maju bangsa	train
ganjar hingga satu kampanye antar provinsi hal sebut cermin empati itu anies dapat tindak nyata rakyat palestina butuh bukan kata kata	train
rocky gerung paham pola pikir anies prabowo hal ganjar pranowo	train
diskus kelompok dukung ganjar tiap beda langsung serang kelompok macam umum rupa dukung prabowo anies sekarang justru	train
putar dukung anies banyak golong putih soal mau dukung prabowo misi beda mau dukung ganjar misi beda misi ubah mau saja	train
ubah bukan pilih anies dari juga selalu pilih pkb pilpres pilih jahat kelamin ganjar prabowo anies akal sehat lebih ganjar	train
juga prabowo sby ahy sby ahy takut bapak kaesang takut ganjar mahfud anies cak imin berani lawan	train
jawa tengah anies muhaimin ganjar mahfud prabowo gibran ganjar unggul	train
anies sama prabowo kalau anies kalah prabowo kalau prabowo kalah anies kelompok parasit	train
baca survey populi center paling aneh baca kondisi beda elektabilitas prabowo ganjar maupun prabowo anies masuk akal	train
survei poltracking baru elektabilitas tiga capres prabowo anies naik ganjar turun	train
peta elektabilitas kini prabowo gibran unggul anies ganjar libat saing ketat	train
persen prabowo gibran persen anies muhaimin undecided belum pilih persen nyata aneh anies muhaimin berapa putar pertama lolos putar	train
prabowo ganjar anies penting bagi indonesia besar soal dunia indonesia butuh pimpin internasional prabowo subianto	train
hasil survei calon presiden anies versus prabowo versus ganjar turut indonesia	train
anies kalah akan pilih prabowo prabowo kalah alih anies parasit usaha dapat	train
prabowo justru serang anies sikap sebut sungguh pantas	train
dukung anies	train
dukung pilpres golong putih pasti akan pilih anies prabowo ganjar peduli visi misi tunggu siapa antara sedia jabat menteri ibu sus tunggu putus ibu sus	train
bukti lembaga survei sebut dasar elektabilitas prabowo gibran jatuh bawah anies	train
jawa timur elektabilitas pasang anies muhaimin capai ganjar mahfud prabowo gibran pasang prabowo gibran unggul atas ganjar mahfud pilih jokowi makin dukung prabowo lanjut maju bangsa	train
prabowo nyata kalah anies sungguh duga	train
menang prabowo jelas lembaga survei cari cari salah balik anies justru lebih percaya survei prancis	train
tanya ganjar anies kena kontribusi supaya banding antar calon presiden tara	train
dasar sebut pasang anies prabowo hasil lolos sedang pilih ganjar pilih anies	train
paham bicara sebut lebih baik anies lebih logis	train
tingkat elektabilitas pasang calon pilpres hari adalah prabowo subianto gibran rakabuming raka ganjar pranowo mahfud anies baswedan muhaimin iskandar pilih belum pilih besar simulasi putar laku cara satu lawan satu	train
pasang prabowo gibran dominasi elektabilitas turut survei pws survei baru pws simulasi tiga nama tunjuk prabowo gibran ganjar mahfud anies muhaimin	train
pilih dua juga penting bukan jokowi banteng dukung prabowo sekarang calon tiga pilih jatuh pada anies perhati kandidat	train
bapak ganjar pranowo prabowo jauh bawah anies rupa sedang hasil survei baik	train
anies baswedan persen susul ganjar pranowo persen turut populi center antara kamis	train
sudah begitu banyak anies masih komentar jika program dapat diskus sama sama	train
juru bicara anies surya tjandra nilai nyata prabowo tunjuk kurang empati hadap buruh timbul anggap anti buruh	train
pasang prabowo gibran dominasi elektabilitas turut survei pws survei baru pws simulasi tiga nama tunjuk prabowo gibran ganjar mahfud anies muhaimin	train
rocky gerung paham cara pikir anies prabowo dengan ganjar	train
hasil survei poltracking tunjuk persen suara pilih prabowo subianto tahun alih pasang anies muhaimin	train
turut hanya prabowo anies mampu macam banding pihak	train
rocky gerung tegas paham alur pikir anies prabowo diskus sedang ganjar diskus	train
rocky gerung paham pola pikir anies prabowo dengan ganjar	train
masuk pilih anies	train
survei pertama tunjuk prabowo subianto gibran rakabuming raka ganjar pranowo mahfud pilih tentu pilih besar survei tunjuk prabowo subianto gibran rakabuming raka anies baswedan muhaimin iskandar pilih tentu pilih besar	train
rocky gerung mampu paham alur pikir anies prabowo ganjar	train
masuk putar adalah prabowo versus anies ini rupa pilih presiden mana prabowo hadap gubernur dki jakarta pernah milik hubung	train
prabowo minta buruh tuntut naik upah juru bicara anies nyata hal sebut tunjuk ketidakpedulian hadap nasib kerja	train
prabowo gibran hadap anies muhaimin hasil prabowo gibran menang oleh persen banyak persen responden nyata tentu pilih persen tolak	train
lembaga survei asal prancis laku survei oktober responden banyak provinsi persen hasil survei tunjuk ganjar mahfud persen prabowo gibran persen anies muhaimin persen belum persen	train
henti prabowo maupun anies akan menang pilpres ganjar akan presiden indonesia sila laksana aktivitas biasa fokus cari nafkah keluarga	train
prabowo minta buruh tuntut naik upah sedang juru bicara anies nyata sebut bagai bukti ketidakpedulian hadap nasib kerja nyata timbul tuduh prabowo anti buruh	train
baik dapat dukung prabowo subianto maupun anies	train
beda signifikan buzzer dukung anies prabowo sama sama sikap	train
hanya tanya lama anies jabat bagai gubernur pihak dapat atur bijak prabowo umum gerindra sungguh utama anies akhir gabung kabinet presiden jokowi	train
survei baru tunjuk pasang prabowo gibran makin jauh ganjar mahfud anies muhaimin	train
anies prabowo ganjar tahun	train
anies milik kerja baik sayang beliau kalah prabowo posisi tengah baik anies prabowo satu akhir indonesia lebih baik	train
tingkat elektabilitas pasang calon pilpres ini prabowo subianto gibran rakabuming raka ganjar pranowo mahfud anies baswedan muhaimin iskandar pilih belum putus	train
ganjar pranowo milik dekat rakyat prabowo subianto tegas cerdas dua unggul sebut gabung semua pada anies baswedan pilih adalah siapa	train
putar pilpres saing anies baswedan prabowo subianto apabila mana turut para dukung pdip alih gabung pks dukung gibran rakabuming raka ini tarik ikut	train
partai demokrat tumpang beri kontribusi nyata prabowo subianto gibran rakabuming raka menang fokus hanya menteri partai anies baswedan akhir jauh	train
dukung prabowo subianto gibran rakabuming raka anies baswedan milik beda satu sama	train
muhaimin iskandar biasa cak imin bagai calon wakil presiden anies baswedan	train
meski bukan dukung anies baswedan sebut benar benar bahas rencana program beda buzzer serang pihak sementara prabowo subianto cenderung sikap tenang pilih golong putih rasa suara	train
rocky gerung paham pola pikir anies baswedan prabowo subianto hal ganjar pranowo	train
pilih anies baswedan padahal prabowo subianto alam calon diri banyak tiga	train
survei populi center tunjuk pasang prabowo subianto gibran rakabuming raka sehingga saing pasang prabowo subianto mahfud pasang anies baswedan muhaimin iskandar	train
bapak prabowo menang anak anak makan gratis berapa lama bapak ganjar menang gaji gaji siapa bapak anies menang gratis tingkat itu mana negara sedang	train
wah wah wah prabowo minta buruh tuntut naik upah juru bicara anies bukti peduli nasib kerja anti buruh	train
semua jangan prabowo anies menang ganjar akan presiden aktivitas cari nafkah keluarga	train
buzzer ganjar survey ganjar nomor buzzer prabowo survey prabowo nomor pdip gerindra suara survey anies selalu main	train
bapak prabowo pantas banyak suka lihat beliau jalan sayang bapak prabowo cara pilih bapak anies	train
memang benar kalau simulasi head head ganjar mahfud anies imin kalau prabowo gibran ganjar mahfud	train
pasang prabowo gibran dominasi elektabilitas turut survei pws survei baru pws simulasi tiga nama prabowo gibran gnajar mahfud anies muhaimin	train
pasang prabowo gibran dominasi elektabilitas turut survei pws survei baru pws simulasi tiga nama prabowo gibran gnajar mahfud anies muhaimin	val
hasil survei capres cawapres anies cak imin prabowo gibran ganjar saing ketat	val
prabowo larang buruh tuntut naik upah juru bicara anies sedikit paham lapang prabowo anti buruh	val
masih pikir sayang prabowo subianto gibran rakabuming raka bagai calon wakil presiden mahfud pasang ganjar pranowo anies baswedan muhaimin iskandar demikian tampak semua atur	val
hasil simulasi putar pasang prabowo subianto gibran rakabuming raka pasang ganjar pranowo mahfud pilih belum pilih simulasi pasang prabowo subianto gibran rakabuming raka pasang anies baswedan muhaimin iskandar pilih belum pilih	val
masyarakat suka anies baswedan karakter pilih jokowi bukan pdip lebih cenderung pilih anies baswedan prabowo subianto karakter anies tenang lebih jokowi demikian tentu akan pilih anies baswedan belum rasa dekat cara	val
tiga kandidat pilih prabowo subianto anies baswedan lolos putar pilih ganjar pranowo lolos putar pilih ganjar pranowo	val
mahfud calon wakil presiden anies baswedan prabowo subianto	test
juru bicara anies baswedan surya tjandra nilai calon presiden prabowo subianto lihat empati hadap buruh larang tuntut naik upah turut sebut bukti usaha paham juang buruh	test
dukung prabowo subianto anies baswedan rasa	test
simulasi putar pasang prabowo subianto gibran rakabuming raka pasang ganjar pranowo mahfud pilih tentu pilih simulasi pasang prabowo subianto gibran rakabuming raka raih pasang anies baswedan muhaimin iskandar pilih tentu pilih	test
dasar bagai kait pilih presiden prabowo subianto tampak unggul sedang ganjar pranowo anies baswedan tunjuk hasil masuk prabowo subianto unggul	test
ingin tanya anies baswedan bagaimana beliau rencana atas miskin prabowo subianto atas miskin beri makan siang gratis sebut mudah	test
hasil survei sebut tampak survei sebut peringkat pertama tempat ganjar susul prabowo anies	test
lebih baik presiden terus	test
elektabilitas anies muhaimin paling survei poltracking sedang prabowo tempat posisi	test
harus pikir prabowo bukankah anies dukung bukankah sebut sikap itu	test
pasang prabowo subianto gibran rakabuming raka unggul banding head head lawan pasang ganjar pranowo mahfud anies baswedan muhaimin iskandar	test
prabowo subianto gibran rakabuming raka ganjar pranowo mahfud pilih belum putus banding anies baswedan muhaimin iskandar prabowo subianto gibran rakabuming raka anies baswedan muhaimin iskandar pilih belum putus	test
prabowo larang buruh tuntut naik upah juru bicara anies nilai bijak sebut kurang paham kondisi lapang tuduh prabowo sikap anti buruh	test
survei apabila prabowo kalah sebut timbul pada tahun hingga soal presiden pada nyata elektabilitas pasang prabowo gibran ini pada peringkat tiga bawah anies	test
survei poltracking tunjuk elektabilitas tiga calon presiden prabowo ganjar anies	test
survei poltracking tunjuk elektabilitas prabowo unggul posisi atas kalah ganjar anies	test
